//MAP CONVERTED BY dmm2tgm.py THIS HEADER COMMENT PREVENTS RECONVERSION, DO NOT REMOVE
"a" = (
/turf/closed/indestructible/vaultdoor,
/area/f13/bunker)
"b" = (
/obj/structure/decoration/vent,
/turf/closed/indestructible/vaultdoor,
/area/f13/bunker)
"c" = (
/turf/template_noop,
/area/template_noop)
"d" = (
/obj/effect/spawner/lootdrop/f13/resourcespawner,
/turf/open/floor/plating/tunnel,
/area/f13/bunker)
"e" = (
/turf/open/floor/plating/tunnel,
/area/f13/bunker)
"f" = (
/obj/structure/wreck/trash/brokenvendor,
/obj/effect/decal/cleanable/glass,
/turf/open/floor/plating/tunnel,
/area/f13/bunker)
"g" = (
/obj/machinery/porta_turret/syndicate,
/turf/open/floor/plating/tunnel,
/area/f13/bunker)
"h" = (
/obj/structure/reagent_dispensers/barrel/dangerous,
/obj/effect/spawner/lootdrop/f13/medical/vault/meds,
/turf/open/floor/plating/tunnel,
/area/f13/bunker)
"i" = (
/obj/structure/wreck/trash/engine,
/obj/effect/spawner/lootdrop/f13/weapon/melee/tier4,
/turf/open/floor/plating/tunnel,
/area/f13/bunker)
"j" = (
/obj/structure/reagent_dispensers/barrel/dangerous,
/obj/effect/decal/cleanable/glass,
/turf/open/floor/plating/tunnel,
/area/f13/bunker)
"k" = (
/obj/structure/simple_door/bunker/glass,
/turf/open/floor/plating/tunnel,
/area/f13/bunker)
"l" = (
/obj/item/reagent_containers/food/snacks/deadmouse,
/turf/open/floor/plating/tunnel,
/area/f13/bunker)
"m" = (
/obj/effect/spawner/lootdrop/f13/traitbooks,
/turf/open/floor/plating/tunnel,
/area/f13/bunker)
"n" = (
/obj/effect/decal/cleanable/generic,
/turf/open/floor/plating/tunnel,
/area/f13/bunker)
"o" = (
/obj/effect/decal/cleanable/dirt,
/turf/open/floor/plating/tunnel,
/area/f13/bunker)
"p" = (
/obj/effect/decal/remains/human,
/obj/effect/decal/cleanable/dirt,
/turf/open/floor/plating/tunnel,
/area/f13/bunker)
"q" = (
/obj/structure/sign/poster/ripped,
/turf/closed/indestructible/vaultdoor,
/area/f13/bunker)
"r" = (
/obj/structure/wreck/trash/machinepiletwo,
/obj/effect/decal/cleanable/glass,
/turf/open/floor/plating/tunnel,
/area/f13/bunker)
"s" = (
/obj/effect/decal/cleanable/glass{
	pixel_x = -14;
	pixel_y = -20
	},
/obj/effect/spawner/lootdrop/f13/resourcespawner,
/turf/open/floor/plating/tunnel,
/area/f13/bunker)
"t" = (
/obj/structure/reagent_dispensers/barrel/dangerous,
/turf/open/floor/plating/tunnel,
/area/f13/bunker)
"u" = (
/obj/effect/decal/cleanable/shreds,
/turf/open/floor/plating/tunnel,
/area/f13/bunker)
"v" = (
/mob/living/simple_animal/mouse,
/turf/open/floor/plating/tunnel,
/area/f13/bunker)
"w" = (
/obj/structure/wreck/trash/machinepile,
/turf/open/floor/plating/tunnel,
/area/f13/bunker)
"x" = (
/obj/effect/decal/cleanable/dirt,
/obj/effect/spawner/lootdrop/trash,
/turf/open/floor/plating/tunnel,
/area/f13/bunker)
"y" = (
/obj/effect/decal/cleanable/glass,
/turf/open/floor/plating/tunnel,
/area/f13/bunker)
"z" = (
/obj/effect/mine/stun,
/obj/effect/decal/cleanable/dirt,
/turf/open/floor/plating/tunnel,
/area/f13/bunker)
"A" = (
/obj/structure/simple_door/bunker,
/obj/structure/decoration/rads{
	pixel_y = 30
	},
/turf/open/floor/vault,
/area/f13/bunker)
"B" = (
/obj/effect/mine/explosive,
/turf/open/floor/plating/tunnel,
/area/f13/bunker)
"C" = (
/obj/effect/decal/remains/human{
	pixel_x = 16;
	pixel_y = 16
	},
/obj/effect/decal/cleanable/dirt,
/obj/effect/spawner/lootdrop/f13/cash_random_med,
/turf/open/floor/plating/tunnel,
/area/f13/bunker)
"D" = (
/obj/effect/decal/remains/human{
	pixel_x = 7;
	pixel_y = -6
	},
/turf/open/floor/plating/tunnel,
/area/f13/bunker)
"E" = (
/obj/structure/simple_door/bunker,
/turf/open/floor/plating/tunnel,
/area/f13/bunker)
"F" = (
/obj/effect/decal/remains/human{
	pixel_x = 0;
	pixel_y = -16
	},
/turf/open/floor/plating/tunnel,
/area/f13/bunker)
"G" = (
/obj/effect/decal/remains/human{
	pixel_x = -6;
	pixel_y = 4
	},
/obj/effect/spawner/lootdrop/f13/cash_random_med,
/turf/open/floor/plating/tunnel,
/area/f13/bunker)
"H" = (
/obj/effect/decal/cleanable/generic{
	pixel_x = 11;
	pixel_y = -10
	},
/turf/open/floor/plating/tunnel,
/area/f13/bunker)
"I" = (
/obj/effect/spawner/lootdrop/trash,
/turf/open/floor/plating/tunnel,
/area/f13/bunker)
"J" = (
/obj/effect/spawner/lootdrop/f13/cash_random_med,
/turf/open/floor/plating/tunnel,
/area/f13/bunker)
"K" = (
/obj/effect/decal/remains/human,
/obj/effect/spawner/lootdrop/f13/cash_random_med,
/turf/open/floor/plating/tunnel,
/area/f13/bunker)
"L" = (
/obj/effect/spawner/lootdrop/f13/weapon/melee/tier4,
/turf/open/floor/plating/tunnel,
/area/f13/bunker)
"M" = (
/obj/structure/sign/poster/prewar/vault_tec{
	pixel_y = 32
	},
/turf/open/floor/plating/tunnel,
/area/f13/bunker)
"N" = (
/obj/effect/mine/stun,
/turf/open/floor/plating/tunnel,
/area/f13/bunker)
"O" = (
/obj/structure/simple_door/bunker,
/turf/open/floor/vault,
/area/f13/bunker)

(1,1,1) = {"
a
a
a
a
a
a
b
q
a
a
a
a
a
a
c
"}
(2,1,1) = {"
b
d
e
m
a
r
e
e
e
t
a
e
t
a
a
"}
(3,1,1) = {"
a
e
g
e
a
s
g
e
e
e
k
e
e
d
a
"}
(4,1,1) = {"
a
f
e
e
a
t
e
o
D
e
a
e
e
g
b
"}
(5,1,1) = {"
a
a
k
a
a
a
a
M
e
e
a
a
a
a
a
"}
(6,1,1) = {"
a
g
e
e
p
o
x
e
e
e
H
o
t
a
a
"}
(7,1,1) = {"
b
h
l
e
e
u
o
o
g
e
e
J
e
N
O
"}
(8,1,1) = {"
a
g
e
n
e
v
e
B
e
G
e
y
o
a
a
"}
(9,1,1) = {"
a
a
k
a
a
a
a
M
e
e
a
a
a
a
a
"}
(10,1,1) = {"
a
i
e
o
a
g
e
o
e
e
e
l
e
t
a
"}
(11,1,1) = {"
a
j
e
e
a
w
e
n
e
o
I
K
e
g
b
"}
(12,1,1) = {"
a
a
e
e
a
a
a
a
E
a
a
e
e
a
a
"}
(13,1,1) = {"
c
b
d
g
a
g
y
C
e
g
a
L
g
b
c
"}
(14,1,1) = {"
c
a
a
a
a
l
z
e
F
t
a
b
a
a
c
"}
(15,1,1) = {"
c
c
c
c
a
a
A
a
b
a
a
c
c
c
c
"}
