//MAP CONVERTED BY dmm2tgm.py THIS HEADER COMMENT PREVENTS RECONVERSION, DO NOT REMOVE
"a" = (
/mob/living/simple_animal/hostile/handy/assaultron,
/turf/open/floor/pod/light,
/area/f13/bunker)
"b" = (
/turf/closed/indestructible/vaultdoor,
/area/f13/bunker)
"c" = (
/turf/template_noop,
/area/f13/bunker)
"d" = (
/turf/template_noop,
/area/template_noop)
"e" = (
/obj/structure/table_frame,
/turf/open/floor/pod/light,
/area/f13/bunker)
"f" = (
/turf/open/floor/pod/light,
/area/f13/bunker)
"g" = (
/obj/structure/rack,
/obj/item/clothing/suit/radiation,
/obj/effect/spawner/lootdrop/f13/medical/wasteland/meds,
/turf/open/floor/pod/light,
/area/f13/bunker)
"h" = (
/obj/structure/simple_door/bunker/glass,
/turf/open/floor/pod/light,
/area/f13/bunker)
"i" = (
/turf/open/floor/pod/dark,
/area/f13/bunker)
"j" = (
/obj/structure/simple_door/bunker,
/turf/open/floor/pod/dark,
/area/f13/bunker)
"k" = (
/obj/structure/rack,
/obj/item/clothing/suit/radiation,
/obj/effect/spawner/lootdrop/f13/medical/vault/meds,
/turf/open/floor/pod/light,
/area/f13/bunker)
"l" = (
/obj/machinery/shower{
	layer = 2.8;
	pixel_y = 32
	},
/obj/structure/decoration/vent,
/turf/open/floor/pod/light,
/area/f13/bunker)
"m" = (
/mob/living/simple_animal/hostile/handy/gutsy,
/turf/open/floor/pod/light,
/area/f13/bunker)
"n" = (
/obj/effect/turf_decal/bot_red,
/turf/open/floor/pod/dark,
/area/f13/bunker)
"o" = (
/obj/effect/decal/cleanable/ash,
/obj/effect/spawner/lootdrop/f13/armor/tier3,
/obj/effect/turf_decal/bot_red,
/turf/open/floor/pod/light,
/area/f13/bunker)
"p" = (
/obj/structure/table,
/obj/effect/spawner/lootdrop/f13/cash_random_med,
/turf/open/floor/pod/light,
/area/f13/bunker)
"q" = (
/mob/living/simple_animal/hostile/handy/assaultron,
/turf/open/floor/pod/dark,
/area/f13/bunker)
"r" = (
/obj/machinery/shower{
	layer = 2.8;
	pixel_y = 32
	},
/obj/structure/decoration/vent,
/obj/effect/spawner/lootdrop/f13/junkspawners,
/turf/open/floor/pod/light,
/area/f13/bunker)
"s" = (
/obj/machinery/shower{
	layer = 2.8;
	pixel_y = 32
	},
/obj/structure/decoration/vent,
/obj/effect/spawner/lootdrop/f13/weapon/melee/tier1,
/turf/open/floor/pod/light,
/area/f13/bunker)
"t" = (
/obj/effect/decal/cleanable/ash/large,
/obj/effect/spawner/lootdrop/f13/armor/clothes,
/obj/item/storage/fancy/ringbox/diamond,
/turf/open/floor/pod/light,
/area/f13/bunker)
"u" = (
/obj/machinery/light/small{
	dir = 1
	},
/turf/open/floor/pod/dark,
/area/f13/bunker)
"v" = (
/obj/item/clothing/suit/radiation,
/turf/open/floor/pod/dark,
/area/f13/bunker)
"w" = (
/mob/living/simple_animal/hostile/handy/securitron,
/turf/open/floor/pod/dark,
/area/f13/bunker)
"x" = (
/obj/structure/simple_door/bunker,
/obj/structure/decoration/rads{
	pixel_y = 30
	},
/turf/open/floor/pod/dark,
/area/f13/bunker)
"y" = (
/obj/effect/spawner/lootdrop/f13/weapon/gun/ammo/tier2,
/turf/open/floor/pod/dark,
/area/f13/bunker)
"z" = (
/obj/structure/decoration/rads{
	pixel_y = 30
	},
/obj/structure/decoration/rads{
	pixel_y = -28
	},
/turf/open/floor/pod/dark,
/area/f13/bunker)
"A" = (
/obj/effect/decal/cleanable/ash/large,
/obj/effect/spawner/lootdrop/f13/armor/clothes,
/turf/open/floor/pod/dark,
/area/f13/bunker)
"B" = (
/obj/effect/spawner/lootdrop/f13/cash_random_med,
/turf/open/floor/pod/light,
/area/f13/bunker)
"C" = (
/mob/living/simple_animal/hostile/handy/robobrain,
/turf/open/floor/pod/light,
/area/f13/bunker)
"D" = (
/obj/machinery/shower{
	dir = 1;
	icon_state = "shower"
	},
/obj/structure/decoration/vent,
/turf/open/floor/pod/light,
/area/f13/bunker)
"E" = (
/obj/machinery/shower{
	dir = 1;
	icon_state = "shower"
	},
/obj/structure/decoration/vent,
/obj/effect/spawner/lootdrop/f13/junkspawners,
/turf/open/floor/pod/light,
/area/f13/bunker)
"F" = (
/turf/closed/indestructible/riveted/uranium,
/area/f13/bunker)
"G" = (
/obj/structure/rack,
/obj/effect/spawner/lootdrop/f13/crafting,
/turf/open/floor/pod/light,
/area/f13/bunker)
"H" = (
/obj/effect/spawner/lootdrop/f13/junkspawners,
/turf/open/floor/pod/dark,
/area/f13/bunker)
"I" = (
/obj/structure/decoration/rads{
	pixel_y = 30
	},
/turf/open/floor/pod/dark,
/area/f13/bunker)
"J" = (
/obj/structure/decoration/cctv{
	pixel_y = 29
	},
/mob/living/simple_animal/hostile/handy/protectron,
/turf/open/floor/pod/dark,
/area/f13/bunker)
"K" = (
/obj/structure/decoration/rads{
	pixel_y = 30
	},
/turf/open/floor/pod/light,
/area/f13/bunker)
"L" = (
/obj/effect/spawner/lootdrop/f13/weapon/gun/tier1,
/turf/open/floor/pod/light,
/area/f13/bunker)
"M" = (
/obj/effect/decal/cleanable/ash,
/obj/effect/spawner/lootdrop/f13/armor/clothes,
/obj/item/throwing_star/throwingknife,
/turf/open/floor/pod/light,
/area/f13/bunker)
"N" = (
/obj/machinery/light/small{
	dir = 4;
	pixel_y = 16
	},
/mob/living/simple_animal/hostile/handy/assaultron,
/turf/open/floor/pod/dark,
/area/f13/bunker)
"O" = (
/obj/effect/spawner/lootdrop/f13/armor/tier3,
/turf/open/floor/pod/light,
/area/f13/bunker)
"P" = (
/obj/structure/decoration/rads{
	pixel_y = -28
	},
/obj/effect/spawner/lootdrop/f13/crafting,
/obj/machinery/light/small,
/turf/open/floor/pod/dark,
/area/f13/bunker)
"Q" = (
/obj/effect/mob_spawn/human/corpse/vault,
/turf/open/floor/pod/dark,
/area/f13/bunker)
"R" = (
/obj/effect/decal/cleanable/ash,
/obj/machinery/light/small{
	dir = 4;
	light_color = "red";
	pixel_y = 0
	},
/turf/open/floor/pod/light,
/area/f13/bunker)
"S" = (
/obj/machinery/light/small{
	dir = 4;
	pixel_y = 16
	},
/turf/open/floor/pod/dark,
/area/f13/bunker)
"T" = (
/obj/effect/decal/cleanable/ash,
/obj/machinery/light/small{
	brightness = 3;
	dir = 8
	},
/turf/open/floor/pod/light,
/area/f13/bunker)
"U" = (
/obj/machinery/light/small{
	dir = 4;
	light_color = "red";
	pixel_y = 0
	},
/turf/open/floor/pod/light,
/area/f13/bunker)
"V" = (
/obj/structure/table,
/obj/machinery/light/small,
/turf/open/floor/pod/light,
/area/f13/bunker)

(1,1,1) = {"
b
b
b
b
b
b
b
b
b
b
b
b
b
b
c
"}
(2,1,1) = {"
b
g
b
m
b
p
b
m
b
e
b
H
L
b
b
"}
(3,1,1) = {"
b
a
b
h
b
h
b
h
b
h
b
I
f
e
b
"}
(4,1,1) = {"
b
f
h
i
i
N
i
y
S
i
j
i
M
V
b
"}
(5,1,1) = {"
b
b
b
i
b
b
b
b
b
b
b
J
i
H
b
"}
(6,1,1) = {"
b
e
h
i
b
e
t
a
f
B
b
b
i
i
b
"}
(7,1,1) = {"
b
b
b
j
b
f
i
Q
y
f
T
b
b
I
j
"}
(8,1,1) = {"
b
m
h
i
b
f
P
b
i
C
F
f
b
b
b
"}
(9,1,1) = {"
b
b
b
u
n
q
i
b
n
f
f
f
f
a
b
"}
(10,1,1) = {"
b
f
h
f
o
f
f
b
j
b
b
K
F
f
b
"}
(11,1,1) = {"
b
k
b
m
b
b
b
b
z
b
G
f
U
O
b
"}
(12,1,1) = {"
b
b
b
b
b
l
v
i
A
b
b
b
b
b
b
"}
(13,1,1) = {"
d
d
d
d
b
r
w
f
f
D
b
d
d
d
d
"}
(14,1,1) = {"
d
d
d
d
b
s
i
R
f
E
b
d
d
d
d
"}
(15,1,1) = {"
d
d
d
d
b
b
x
b
b
b
b
d
d
d
d
"}
