//MAP CONVERTED BY dmm2tgm.py THIS HEADER COMMENT PREVENTS RECONVERSION, DO NOT REMOVE
"a" = (
/turf/closed/wall/f13/tunnel,
/area/shuttle/brotherhood_of_steel)
"c" = (
/turf/open/floor/plasteel/dark,
/area/shuttle/brotherhood_of_steel)
"d" = (
/obj/machinery/door/airlock/hatch{
	req_access_txt = "120"
	},
/obj/docking_port/mobile/bos{
	dwidth = 1;
	name = "Broterhood_of_Steel"
	},
/turf/closed/wall/f13/tunnel,
/area/shuttle/brotherhood_of_steel)
"h" = (
/turf/template_noop,
/area/template_noop)
"j" = (
/obj/machinery/computer/shuttle/bos,
/turf/open/floor/plasteel/dark,
/area/shuttle/brotherhood_of_steel)
"p" = (
/obj/structure/ladder/unbreakable{
	height = 2;
	id = "SE"
	},
/turf/open/floor/plasteel/dark,
/area/shuttle/brotherhood_of_steel)
"t" = (
/turf/closed/wall/r_wall/f13/vault,
/area/shuttle/brotherhood_of_steel)

(1,1,1) = {"
a
a
d
a
a
h
"}
(2,1,1) = {"
a
t
c
t
a
h
"}
(3,1,1) = {"
a
t
c
t
a
a
"}
(4,1,1) = {"
a
t
c
t
t
a
"}
(5,1,1) = {"
a
t
c
c
t
a
"}
(6,1,1) = {"
a
t
c
c
t
a
"}
(7,1,1) = {"
a
t
j
p
t
a
"}
(8,1,1) = {"
a
t
t
t
t
a
"}
(9,1,1) = {"
a
a
a
a
a
a
"}
